W W W W W W W W W W W W W W W W W W W W W W W W W W W W W
W _ B B B B B I _ _ _ _ _ B B B B B 3 W W Z W I W W W W W
W _ W W W W B W _ _ _ _ _ B W W W W B W W Z W _ _ _ _ _ _
W _ W W b W B _ W W W W W B W W W W B W W _ W W W W W W W
W _ B B B B b _ B B B M B B B _ B B B W W _ W W W W W W W
W _ W W W W W W I I B B B B B B B B B W W _ W W W W W W W
W _ W W W W W W W W W W W W W W I W B B B _ W W W W W W W
W _ B B B B B B B B B B B B B B B B B W B _ W W W W W W W
W _ _ _ _ _ B W W M W W B W W W W W E W B B B B W W W W W
W B W W W W B W W W W B W W W W W B W W W B W W W W W W W
W B W W W W B W W W W W B W W W W W B W W W W W W W W W W