F F F F F F F F F F F F F F F F F F F F F F F F F F F F F F F F F F F F F F F F F F F F F F F F F F F F F F F F F F F F
F B B B B B B B _ _ _ _ _ B B B B B B B B I B I B B B B B B B B B B B B I B I B B B B B B B B B B B B I B I B B B B B F
F B B b B b B B _ _ _ _ _ B B B B B B B B I B _ _ _ _ _ F B B B B B B B I B I B B B B B B B B B B B B I B I B B B B B F
F B B B b B B B B B B B B B B B B B B B B B I B B B B B F B B B B B B B I B I B B B B B B B B B B B B I B I B B B B B F
F B B b B B b B B B B M B B B _ B B B B B _ B B B B B B F B B B B B B B I B I B B B B B B B B B B B B I B I B B B B B F
F B B B B _ B B I I B B B B B B B B B B B _ B B B B B B F B B B B B B B I B I B B B B B B B B B B B B I B I B B B B B F
F _ B B B _ B B B B B B B B B B I B B B B _ B B B B B B F B B B B B B B I B I B B B B B B B B B B B B I B I B B B B B F
F _ B B B _ B B B B B B B B B B B B B B B _ B Z Z B B B F B B B B B B B I B I B B B B B B B B B B B B I B I B B B B B F
F _ _ _ _ B B B Z _ B B B W W W W B E B B B B Z Z B B B F B B B B B B B I B I B B B B B B B B B B B B I B I B B B B B F
F B W W W W B W W _ B B W W W W W B B _ B B W W W W W W F B B B B B B B I B I B B B B B B B B B B B B I B I B B B B B F
F B B B B B B B B B B B B B B B B B B S B B B B B B B B F B B B B B B B I B I B B B B B B B B B B B B I B I B B B B B F
F B B B B M B B e _ B B B B B B _ _ _ _ B B B B B S B B F B B B B B B B I B I B B B B B B B B B B B B I B I B B B B B F
F B B B B B B B B B B B B B B B B B B B B B B B B B B B F B B B B B B B I B I B B B B B B B B B B B B I B I B B B B B F
F B B B B B B B B B B B B B B B B B B B B B B B B B B B B B B B B B B B B B B B B B B B B B B B B B B I B I B B B B B F
F B B B B B B B B B B B B B B B B B B B B B B B B B B B B B B B B B B B B B B B B B B B B B B B B B B I B I B B B B B F
F B B B B B B B B B B B B B B B B B B B B B B B B B B B B B B B B B B B B B B B B B B B B B B B B B B I B I B B B B B F
F B B B B B B B B B B B B B B B B B B B B B B B B B B B B B B B B B B B B B B B B B B B B B B B B B B I B I B B B B B F
F B B B B B B B B B B B B B B B B B B B B B B B B B B B B B B B B B B B B B B B B B B B B B B B B B B I B I B B B B B F
F B B B B B B B B B B B B B B B B B B B B B B B B B B B B B B B B B B B B B B B B B B B B B B B B B B I B I B B B B B F
F B B B B B B B B B B B B B B B B B B B B B B B B B B B B B B B B B B B B B B B B B B B B B B B B B B I B I B B B B B F
F B B B B B B B B B B B B B B B B B B B B B B B B B B B B B B B B B B B B B B B B B B B B B B B B B B I B I B B B B B F
F B B B B B B B B B B B B B B B B B B B B B B B B B B B B B B B B B B B B B B B B B B B B B B B B B B I B I B B B B B F
F B B B B B B B B B B B B B B B B B B B B B B B B B B B B B B B B B B B B B B B B B B B B B B B B B B I B I B B B B B F
F F F F F F F F F F F F F F F F F F F F F F F F F F F F F F F F F F F F F F F F F F F F F F F F F F F F F F F F F F F F