F F F F F F F F F F F F F F F F F F F F F F F F F F F F F F F F F F F F F F F F F F F F F F F F F F F F F F F F F F F F
F M Z B B B B B B B B Z Z B B B B B B B B I B I B B B B B B B B B B B B I B I B B B B B B B B B B B B I B I B B B B B F
F B Z b B b B b B B B B B B B B B B B B B I B B B B B B F B B B B B B B I B I B B B B B B B B B B B B I B I B B B B B F
F B B B B B B B B B B B B B B B B B B B B B I B B B B B F B B B B B B B I B I B B B B B B B B B B B B I B I B B B B B F
F B B B B B B B B B B B B B B B B B B B B B B B B B B B F B B B B B B B I B I B B B B B B B B B B B B I B I B B B B B F
F B B B B B B B I I B B B B B B B B B B B B B B B B B B F B B B B B B B I B I B B B B B B B B B B B B I B I B B B B B F
F B B B B B B B B B B B B B B B I B B B B B B B B B B B F B B B B B B B I B I B B B B B B B B B B B B I B I B B B B B F
F B B B B B B B B B B B B B B B B B B B B B B Z Z B B B F B B B B B B B I B I B B B B B B B B B B B B I B I B B B B B F
F B B B B B B B Z B B B B W W W W B E B B B B Z Z B B B F B B B B B B B I B I B B B B B B B B B B B B I B I B B B B B F
F B W W W W B W W B B B W W W W W B B B B B W W W W W W F B B B B B B B I B I B B B B B B B B B B B B I B I B B B B B F
F B B B B B B B B B B B B B B B B B B B B B B B B B B B F B B B B B B B I B I B B B B B B B B B B B B I B I B B B B B F
F B B B B B B B B B B B B B B B B B B e B B B B B B B B F B B B B B B B I B I B B B B B B B B B B B B I B I B B B B B F
F B B B B B B B B B B B B B S B B B B B B B B B B B B B F B B B B B B B I B I B B B B B B B B B B B B I B I B B B B B F
F B B B B B B B B B B B B B B B B B B B B B B B B B B B B B B B B B B B B B B B B B B B B B B B B B B I B I B B B B B F
F B B B B B B B B B B B B B B B B B B B B B B B B B B B B B B B B B B B B B B B B B B B B B B B B B B I B I B B B B B F
F B B B B B B B B B B B B B B B B B B B B B B B B B B B B B B B B B B B B B B B B B B B B B B B B B B I B I B B B B B F
F B B B B B B B B B B B B B B B B B B B B B B B B B B B B B B B B B B B B B B B B B B B B B B B B B B I B I B B B B B F
F B B B B B B B B B B B B B B B B B B B B B B B B B B B B B B B B B B B B B B B B B B B B B B B B B B I B I B B B B B F
F B B B B B B B B B B B B B B B B B B B B B B B B B B B B B B B B B B B B B B B B B B B B B B B B B B I B I B B B B B F
F B B B B B B B B B B B B B B B B B B B B B B B B B B B B B B B B B B B B B B B B B B B B B B B B B B I B I B B B B B F
F B B B B B B B B B B B B B B B B B B B B B B B B B B B B B B B B B B B B B B B B B B B B B B B B B B I B I B B B B B F
F B B B B B B B B B B B B B B B B B B B B B B B B B B B B B B B B B B B B B B B B B B B B B B B B B B I B I B B B B B F
F B B B B B B B B B B B B B B B B B B B B B B B B B B B B B B B B B B B B B B B B B B B B B B B B B B I B I B B B B B F
F F F F F F F F F F F F F F F F F F F F F F F F F F F F F F F F F F F F F F F F F F F F F F F F F F F F F F F F F F F F