F F F F F F F F F F F F F F F F F F F F F F F F F F F F F F
F M Z B B B B B B B B Z Z B B B B B B B B I B I B B B B B F
F B Z b B b B b B B B B B B B R R B B B B I B B B B B B B F
F B B B B B B B B B B B B B B R R B B Y B Y I B B B B B B F
F B B B B B B B B B B B B B B B B B B B B B B B B B B B B F
F B r B l B B B I I B B B B B B O B O Y B Y F B B B B B B F
F B B B B B B B B B B B B B S B I B B B B W W B B B B B B F
F B d B u B B B B B B B B B B B B B B B B B B Z Z B B B B F
F B B B B B B B Z B B B B B W W W B E B T B B Z Z B B B B F
F B C B H B V W W B B B W B e W W B B B B B W W W W W B B F
F B B B B B B B B B B B B B B B B B B B B B B B B B B B B F
F F F F F F F F F F F F F F F F F F F F F F F F F F F F F F