F F F F F F F F F F F F F F F F F F F F F F F F F F F F F F
F B Z B B I B _ E B B Z Z B B B B B B B B I B I B B B B B F
F B Z b B _ B b B B B _ _ B B R R B B B B I B B B B B B B F
F B B B B _ B B B B B B _ B B R R B B Y B Y I B B B B B B F
F B B B M _ B B B B B B B B B B B B B B B B B B B B B B B F
F B r B l _ B B I I B B _ _ _ B O B O Y B Y F B B B B B B F
F B B B B _ B B B B B B _ _ S B I B B B B W W B B B B B B F
F B d B u _ B B B B B B _ _ _ B B B B B B B B Z Z B B B B F
F B B B B B B B Z B B B B B W W W B E B T B B Z Z B B B B F
F B C B H B V W W B B B W B e _ _ _ B B B B W W W W W B B F
F B B B B B B B B B B B B B _ _ _ _ B B B B B B B B B B B F
F F F F F F F F F F F F F F F F F F F F F F F F F F F F F F